NO ./wall_texters/N.xpm

SO ./wall_texters/S.xpm

WE ./wall_texters/W.xpm

EA   ./wall_texters/E.xpm

F  17,17,40
C  105,65,192


11111111111 11111111111111
10000100001 1000000000111
10111100001111C1110100001
1100C00000000000000C0011
10111110001100000001000011
11     1000W000000000000011
10111110001100000001000011
101100000111000000001001
100100000000001000000001
111111111111101111111111
111111111111111111111111